19 30
******************************
* . . . . . . . . . . . . . .*
*. . . . . . . . . . . . . . *
* . . . . . . . . . . . . . .*
*. . . . . . . . . . . . . . *
* . . . . . . . . . . . . . .*
*. . . . . . . . . . . . . . *
* . . . . . . . . . . . . . .*
*. . . . . . . . . . . . . . *
* . . . . . . . . . . . . . .*
*. . . . . . . . . . . . . . *
* . . . . . . . . . . . . . .*
*. . . . . . . . . . . . . . *
* . . . . . . . . . . . . . .*
*. . . . . . . . . . . . . . *
* . . . . . . . . . . . . . .*
*. . . . . . . . . . . . . . *
* . . . . . . . . . . . . . .*
******************************